



.......#
......##
.....###
....####
########